timestamp,temp,batt_mV,soundDroop_mV,boltDroop_mV,faults,batteryLevel,Time Elapsed (hours),soundDroopMag_mV,boltDroopMag_mV,meanLevel,nnLevel,fault_brownout,fault_bolt,fault_sound,fault_sound_brownout,fault_bolt_brownout
946688307,39,3184,3123,3094,0,51,0.0,61,90,3,3,False,False,False,False,False
946690111,39,3044,2975,2967,0,51,0.5011111111111111,69,77,3,3,False,False,False,False,False
946691914,39,3004,2936,2917,0,51,1.0019444444444445,68,87,3,3,False,False,False,False,False
946693718,39,2994,2929,2916,0,51,1.5030555555555556,65,78,3,3,False,False,False,False,False
946695521,38,2991,2921,2913,0,51,2.003888888888889,70,78,3,3,False,False,False,False,False
946697324,39,2979,2921,2903,0,51,2.504722222222222,58,76,3,3,False,False,False,False,False
946699128,38,2978,2920,2892,0,51,3.0058333333333334,58,86,3,3,False,False,False,False,False
946700931,38,2979,2919,2906,0,51,3.506666666666667,60,73,3,3,False,False,False,False,False
946702735,38,2971,2917,2891,0,51,4.007777777777778,54,80,3,3,False,False,False,False,False
946704538,38,2976,2915,2903,0,51,4.508611111111111,61,73,3,3,False,False,False,False,False
946706342,38,2964,2914,2895,0,51,5.009722222222222,50,69,3,3,False,False,False,False,False
946708145,38,2972,2910,2902,0,51,5.510555555555555,62,70,3,3,False,False,False,False,False
946709948,38,2978,2909,2898,0,51,6.011388888888889,69,80,3,3,False,False,False,False,False
946711752,38,2969,2904,2897,0,51,6.5125,65,72,3,3,False,False,False,False,False
946713555,38,2973,2904,2892,0,51,7.013333333333334,69,81,3,3,False,False,False,False,False
946715359,38,2969,2904,2892,0,51,7.514444444444444,65,77,3,3,False,False,False,False,False
946717162,39,2964,2908,2896,0,51,8.015277777777778,56,68,3,3,False,False,False,False,False
946718966,38,2969,2904,2898,0,51,8.516388888888889,65,71,3,3,False,False,False,False,False
946720769,39,2964,2906,2892,0,51,9.017222222222221,58,72,3,3,False,False,False,False,False
946722572,38,2970,2904,2892,0,51,9.518055555555556,66,78,3,3,False,False,False,False,False
946724376,38,2972,2904,2892,0,51,10.019166666666667,68,80,3,3,False,False,False,False,False
946726179,38,2967,2907,2892,0,51,10.52,60,75,3,3,False,False,False,False,False
946727983,38,2964,2904,2894,0,51,11.02111111111111,60,70,3,3,False,False,False,False,False
946729786,38,2967,2904,2892,0,51,11.521944444444445,63,75,3,3,False,False,False,False,False
946731589,38,2964,2900,2892,0,51,12.022777777777778,64,72,3,3,False,False,False,False,False
946733393,38,2972,2906,2892,0,51,12.523888888888889,66,80,3,3,False,False,False,False,False
946735196,38,2975,2909,2885,0,51,13.024722222222222,66,90,3,3,False,False,False,False,False
946737000,38,2968,2905,2889,0,51,13.525833333333333,63,79,3,3,False,False,False,False,False
946738803,38,2959,2906,2891,0,51,14.026666666666667,53,68,3,3,False,False,False,False,False
946740607,38,2970,2904,2892,0,51,14.527777777777779,66,78,3,3,False,False,False,False,False
946742410,38,2969,2906,2893,0,51,15.028611111111111,63,76,3,3,False,False,False,False,False
946744214,38,2972,2907,2890,0,51,15.529722222222222,65,82,3,3,False,False,False,False,False
946746017,38,2972,2907,2891,0,51,16.030555555555555,65,81,3,3,False,False,False,False,False
946747820,38,2972,2908,2897,0,51,16.531388888888888,64,75,3,3,False,False,False,False,False
946749624,38,2982,2907,2889,0,51,17.0325,75,93,3,3,False,False,False,False,False
946751427,38,2970,2907,2892,0,51,17.533333333333335,63,78,3,3,False,False,False,False,False
946753231,38,2980,2903,2891,0,51,18.034444444444443,77,89,3,3,False,False,False,False,False
946755034,38,2967,2905,2891,0,51,18.53527777777778,62,76,3,3,False,False,False,False,False
946756837,38,2968,2906,2887,0,51,19.03611111111111,62,81,3,3,False,False,False,False,False
946758641,38,2970,2907,2890,0,51,19.537222222222223,63,80,3,3,False,False,False,False,False
946760444,38,2964,2904,2893,0,51,20.038055555555555,60,71,3,3,False,False,False,False,False
946762248,38,2976,2904,2890,0,51,20.539166666666667,72,86,3,3,False,False,False,False,False
946764051,38,2968,2905,2891,0,51,21.04,63,77,3,3,False,False,False,False,False
946765855,38,2980,2905,2888,0,51,21.54111111111111,75,92,3,3,False,False,False,False,False
946767658,38,2971,2904,2881,0,51,22.041944444444443,67,90,3,3,False,False,False,False,False
946769462,38,2972,2901,2891,0,51,22.543055555555554,71,81,3,3,False,False,False,False,False
946771265,38,2972,2904,2888,0,51,23.04388888888889,68,84,3,3,False,False,False,False,False
946773068,38,2973,2900,2886,0,51,23.544722222222223,73,87,3,3,False,False,False,False,False
946774872,38,2971,2900,2877,0,51,24.045833333333334,71,94,3,3,False,False,False,False,False
946776675,38,2972,2904,2887,0,51,24.546666666666667,68,85,3,3,False,False,False,False,False
946778479,38,2964,2895,2873,0,51,25.047777777777778,69,91,3,3,False,False,False,False,False
946780282,38,2968,2899,2881,0,51,25.54861111111111,69,87,3,3,False,False,False,False,False
946782086,38,2976,2895,2883,0,51,26.049722222222222,81,93,3,3,False,False,False,False,False
946783889,38,2962,2896,2881,0,51,26.550555555555555,66,81,3,3,False,False,False,False,False
946785692,38,2961,2895,2870,0,51,27.051388888888887,66,91,3,3,False,False,False,False,False
946787496,38,2965,2894,2878,0,51,27.5525,71,87,3,3,False,False,False,False,False
946789299,38,2961,2895,2866,0,51,28.053333333333335,66,95,3,3,False,False,False,False,False
946791103,38,2965,2891,2878,0,51,28.554444444444446,74,87,3,3,False,False,False,False,False
946792906,38,2964,2892,2865,0,51,29.05527777777778,72,99,3,3,False,False,False,False,False
946794710,38,2957,2891,2873,0,51,29.55638888888889,66,84,3,3,False,False,False,False,False
946796513,38,2965,2891,2870,0,51,30.057222222222222,74,95,3,3,False,False,False,False,False
946798317,38,2958,2884,2873,0,51,30.558333333333334,74,85,3,3,False,False,False,False,False
946800120,38,2961,2886,2867,0,51,31.059166666666666,75,94,3,3,False,False,False,False,False
946801923,38,2953,2886,2869,0,51,31.56,67,84,3,3,False,False,False,False,False
946803727,38,2959,2882,2865,0,51,32.06111111111111,77,94,3,3,False,False,False,False,False
946805530,38,2951,2880,2862,0,51,32.56194444444444,71,89,3,3,False,False,False,False,False
946807334,38,2954,2878,2860,0,51,33.06305555555556,76,94,3,3,False,False,False,False,False
946809137,38,2954,2871,2862,0,51,33.56388888888889,83,92,3,3,False,False,False,False,False
946810940,38,2947,2876,2859,0,51,34.06472222222222,71,88,3,3,False,False,False,False,False
946812744,38,2956,2876,2855,0,51,34.56583333333333,80,101,3,3,False,False,False,False,False
946814547,38,2949,2872,2854,0,51,35.06666666666667,77,95,3,3,False,False,False,False,False
946816351,38,2941,2868,2852,0,51,35.56777777777778,73,89,3,3,False,False,False,False,False
946818154,38,2938,2865,2849,0,51,36.06861111111111,73,89,3,3,False,False,False,False,False
946819958,38,2938,2861,2846,0,51,36.569722222222225,77,92,3,3,False,False,False,False,False
946821761,38,2949,2863,2841,0,51,37.07055555555556,86,108,3,3,False,False,False,False,False
946823565,38,2940,2861,2843,0,51,37.571666666666665,79,97,3,3,False,False,False,False,False
946825368,38,2939,2856,2840,0,51,38.0725,83,99,3,3,False,False,False,False,False
946827171,38,2939,2860,2834,0,51,38.57333333333333,79,105,3,3,False,False,False,False,False
946828975,38,2932,2850,2831,0,51,39.074444444444445,82,101,3,3,False,False,False,False,False
946830778,38,2930,2852,2828,0,51,39.57527777777778,78,102,3,3,False,False,False,False,False
946832582,38,2936,2846,2826,0,51,40.076388888888886,90,110,3,3,False,False,False,False,False
946834385,38,2923,2842,2821,0,51,40.577222222222225,81,102,3,3,False,False,False,False,False
946836188,38,2927,2837,2814,0,51,41.07805555555556,90,113,3,3,False,False,False,False,False
946837992,38,2924,2835,2816,0,51,41.579166666666666,89,108,3,3,False,False,False,False,False
946839795,38,2912,2834,2808,0,51,42.08,78,104,3,3,False,False,False,False,False
946841599,38,2912,2822,2802,0,51,42.58111111111111,90,110,3,3,False,False,False,False,False
946843402,38,2906,2822,2803,0,51,43.081944444444446,84,103,3,3,False,False,False,False,False
946845206,38,2904,2816,2800,0,51,43.58305555555555,88,104,3,3,False,False,False,False,False
946847009,38,2900,2816,2782,0,51,44.083888888888886,84,118,3,3,False,False,False,False,False
946848813,38,2895,2809,2790,0,51,44.585,86,105,3,3,False,False,False,False,False
946850616,38,2900,2805,2783,0,51,45.08583333333333,95,117,3,3,False,False,False,False,False
946852419,38,2892,2803,2777,0,51,45.586666666666666,89,115,3,3,False,False,False,False,False
946854223,38,2878,2796,2770,0,51,46.08777777777778,82,108,3,3,False,False,False,False,False
946856026,38,2881,2793,2763,0,51,46.58861111111111,88,118,3,3,False,False,False,False,False
946857830,38,2880,2783,2761,0,51,47.08972222222222,97,119,3,3,False,False,False,False,False
946859633,38,2869,2781,2756,0,51,47.590555555555554,88,113,3,3,False,False,False,False,False
946861437,38,2865,2775,2751,0,51,48.09166666666667,90,114,3,3,False,False,False,False,False
946863240,38,2861,2774,2745,0,51,48.5925,87,116,3,3,False,False,False,False,False
946865043,38,2864,2762,2739,0,51,49.093333333333334,102,125,3,3,False,False,False,False,False
946866847,38,2856,2758,2730,0,51,49.59444444444444,98,126,3,3,False,False,False,False,False
946868650,38,2851,2756,2722,0,51,50.09527777777778,95,129,3,3,False,False,False,False,False
946870454,38,2839,2736,2719,0,51,50.59638888888889,103,120,3,3,False,False,False,False,False
946872257,38,2839,2740,2708,0,51,51.09722222222222,99,131,3,3,False,False,False,False,False
946874061,38,2843,2735,2705,0,51,51.598333333333336,108,138,3,3,False,False,False,False,False
946875864,38,2828,2723,2693,0,51,52.09916666666667,105,135,3,3,False,False,False,False,False
946877667,38,2828,2710,2690,0,51,52.6,118,138,3,3,False,False,False,False,False
946879471,38,2824,2713,2682,0,51,53.10111111111111,111,142,3,3,False,False,False,False,False
946881274,38,2822,2706,2680,0,51,53.60194444444444,116,142,3,3,False,False,False,False,False
946883078,38,2812,2696,2658,0,51,54.10305555555556,116,154,3,3,False,False,False,False,False
946884881,38,2814,2693,2664,0,51,54.60388888888889,121,150,3,3,False,False,False,False,False
946886684,38,2807,2689,2655,0,51,55.10472222222222,118,152,3,3,False,False,False,False,False
946888488,38,2802,2688,2657,0,51,55.60583333333334,114,145,3,3,False,False,False,False,False
946890291,38,2799,2677,2642,0,51,56.10666666666667,122,157,3,3,False,False,False,False,False
946892095,38,2797,2671,2638,0,51,56.60777777777778,126,159,3,3,False,False,False,False,False
946893898,38,2787,2663,2622,0,51,57.10861111111111,124,165,3,3,False,False,False,False,False
946895702,38,2783,2659,2624,0,51,57.609722222222224,124,159,3,3,False,False,False,False,False
946897505,38,2775,2653,2604,0,35,58.11055555555556,122,171,3,2,False,False,False,False,False
946899309,38,2770,2649,2604,0,35,58.611666666666665,121,166,3,2,False,False,False,False,False
946901112,38,2771,2635,2601,0,35,59.1125,136,170,3,2,False,False,False,False,False
946902916,38,2760,2629,2591,0,34,59.61361111111111,131,169,2,2,False,False,False,False,False
946904719,38,2759,2628,2588,0,34,60.114444444444445,131,171,2,2,False,False,False,False,False
946906522,38,2750,2617,2575,0,34,60.61527777777778,133,175,2,2,False,False,False,False,False
946908326,38,2747,2607,2561,0,34,61.11638888888889,140,186,2,2,False,False,False,False,False
946910129,38,2740,2600,2558,0,34,61.617222222222225,140,182,2,2,False,False,False,False,False
946911933,38,2730,2590,2543,0,34,62.11833333333333,140,187,2,2,False,False,False,False,False
946913736,38,2719,2579,2533,0,34,62.619166666666665,140,186,2,2,False,False,False,False,False
946915540,38,2718,2568,2524,0,34,63.12027777777778,150,194,2,2,False,False,False,False,False
946917343,38,2716,2564,2519,0,34,63.62111111111111,152,197,2,2,False,False,False,False,False
946919146,38,2701,2548,2486,0,34,64.12194444444444,153,215,2,2,False,False,False,False,False
946920950,38,2691,2538,2481,0,34,64.62305555555555,153,210,2,2,False,False,False,False,False
946922753,38,2682,2524,2468,0,34,65.12388888888889,158,214,2,2,False,False,False,False,False
946924557,38,2673,2498,2436,0,34,65.625,175,237,2,2,False,False,False,False,False
946926360,38,2663,2481,2419,0,34,66.12583333333333,182,244,2,2,False,False,False,False,False
946928164,38,2646,2464,2400,0,18,66.62694444444445,182,246,2,1,False,False,False,False,False
946929967,38,2635,2447,2349,0,18,67.12777777777778,188,286,2,1,False,False,False,False,False
946931771,38,2626,2429,2353,0,18,67.6288888888889,197,273,2,1,False,False,False,False,False
946933574,38,2611,2403,2301,0,17,68.12972222222223,208,310,1,1,False,False,False,False,False
946935377,38,2606,2383,2307,0,17,68.63055555555556,223,299,1,1,False,False,False,False,False
946937181,38,2580,2353,2272,0,17,69.13166666666666,227,308,1,1,False,False,False,False,False
946938984,38,2560,2330,2237,0,17,69.6325,230,323,1,1,False,False,False,False,False
946940788,38,2539,2295,2189,0,17,70.13361111111111,244,350,1,1,False,False,False,False,False
946942591,38,2522,2267,2158,0,17,70.63444444444444,255,364,1,1,False,False,False,False,False
946944394,38,2495,2209,1983,0,17,71.13527777777777,286,512,1,1,False,False,False,False,False
946946198,38,2471,2156,1999,0,17,71.63638888888889,315,472,1,1,False,False,False,False,False
946948001,38,2426,2047,1539,0,17,72.13722222222222,379,887,1,1,False,False,False,False,False
946949805,38,2384,1970,1519,0,17,72.63833333333334,414,865,1,1,False,False,False,False,False
946951608,38,2326,1820,825,0,17,73.13916666666667,506,1501,1,1,False,False,False,False,False
946953412,38,2216,1239,699,0,17,73.64027777777778,977,1517,1,1,False,False,False,False,False
946954661,38,2191,599,662,4,17,73.98722222222223,1592,1529,1,1,False,False,True,False,False
946956470,38,2258,611,643,4,17,74.48972222222223,1647,1615,1,1,False,False,True,False,False
946959181,38,2320,609,640,4,17,75.24277777777777,1711,1680,1,1,False,False,True,False,False
946960089,38,2313,607,664,4,17,75.495,1706,1649,1,1,False,False,True,False,False
946961898,38,2338,609,639,4,17,75.9975,1729,1699,1,1,False,False,True,False,False
946962805,38,2338,607,1134,4,17,76.24944444444445,1731,1204,1,1,False,False,True,False,False
946965515,38,2361,609,643,4,17,77.00222222222222,1752,1718,1,1,False,False,True,False,False
946966422,38,2363,613,643,4,17,77.25416666666666,1750,1720,1,1,False,False,True,False,False
946967328,38,2354,613,642,6,17,77.50583333333333,1741,1712,1,1,False,True,True,False,False
946968237,38,2363,605,642,4,17,77.75833333333334,1758,1721,1,1,False,False,True,False,False
946969143,38,2367,609,635,6,17,78.01,1758,1732,1,1,False,True,True,False,False
946973659,38,2379,613,641,4,17,79.26444444444445,1766,1738,1,1,False,False,True,False,False
946975468,38,2390,609,640,6,17,79.76694444444445,1781,1750,1,1,False,True,True,False,False
946977277,38,2396,609,643,4,17,80.26944444444445,1787,1753,1,1,False,False,True,False,False
946980891,38,2404,610,635,6,17,81.27333333333333,1794,1769,1,1,False,True,True,False,False
946981797,38,2405,610,642,4,17,81.525,1795,1763,1,1,False,False,True,False,False
946982705,38,2397,613,643,6,17,81.77722222222222,1784,1754,1,1,False,True,True,False,False
946985416,38,2412,609,650,4,17,82.53027777777778,1803,1762,1,1,False,False,True,False,False
946986325,38,2406,609,635,6,17,82.78277777777778,1797,1771,1,1,False,True,True,False,False
946989035,38,2419,611,635,4,17,83.53555555555556,1808,1784,1,1,False,False,True,False,False
946990844,38,2419,603,641,6,17,84.03805555555556,1816,1778,1,1,False,True,True,False,False
946992653,38,2416,602,639,4,17,84.54055555555556,1814,1777,1,1,False,False,True,False,False
946993561,38,2421,611,643,6,17,84.79277777777777,1810,1778,1,1,False,True,True,False,False
946994467,38,2409,612,643,4,17,85.04444444444445,1797,1766,1,1,False,False,True,False,False
946998983,38,2437,600,647,6,17,86.29888888888888,1837,1790,1,1,False,True,True,False,False
947001693,38,2436,602,638,4,17,87.05166666666666,1834,1798,1,1,False,False,True,False,False
947002600,38,2434,609,646,6,17,87.30361111111111,1825,1788,1,1,False,True,True,False,False
947006213,38,2444,600,651,4,17,88.30722222222222,1844,1793,1,1,False,False,True,False,False
947017947,39,2451,608,648,6,17,91.56666666666666,1843,1803,1,1,False,True,True,False,False
