timestamp,temp,batt_mV,soundDroop_mV,boltDroop_mV,faults,batteryLevel,Time Elapsed (hours),soundDroopMag_mV,boltDroopMag_mV,meanLevel,nnLevel,fault_brownout,fault_bolt,fault_sound,fault_sound_brownout,fault_bolt_brownout
946693340,-19,3036,1946,1275,0,51,0.0,1090,1761,3,3,False,False,False,False,False
946695144,-19,2783,2220,1827,0,51,0.5011111111111111,563,956,3,3,False,False,False,False,False
946696948,-19,2744,2165,1705,0,51,1.0022222222222221,579,1039,3,3,False,False,False,False,False
946698753,-19,2722,2179,1765,0,51,1.503611111111111,543,957,3,3,False,False,False,False,False
946700557,-19,2729,2165,1669,0,51,2.004722222222222,564,1060,3,3,False,False,False,False,False
946702361,-19,2703,2173,1745,0,51,2.5058333333333334,530,958,3,3,False,False,False,False,False
946704165,-19,2713,2169,1651,0,51,3.0069444444444446,544,1062,3,3,False,False,False,False,False
946705969,-19,2702,2156,1706,0,51,3.5080555555555555,546,996,3,3,False,False,False,False,False
946707773,-19,2696,2146,1630,0,51,4.009166666666666,550,1066,3,3,False,False,False,False,False
946709577,-19,2697,2146,1701,0,51,4.510277777777778,551,996,3,3,False,False,False,False,False
946711381,-19,2698,2130,1602,0,51,5.011388888888889,568,1096,3,3,False,False,False,False,False
946713185,-19,2684,2139,1681,0,51,5.5125,545,1003,3,3,False,False,False,False,False
946714989,-19,2691,2125,1583,0,51,6.0136111111111115,566,1108,3,3,False,False,False,False,False
946716793,-19,2681,2130,1667,0,51,6.514722222222222,551,1014,3,3,False,False,False,False,False
946718597,-19,2681,2117,1570,0,51,7.015833333333333,564,1111,3,3,False,False,False,False,False
946720401,-19,2672,2109,1664,0,51,7.516944444444444,563,1008,3,3,False,False,False,False,False
946722205,-19,2677,2108,1563,0,51,8.018055555555556,569,1114,3,3,False,False,False,False,False
946724010,-19,2662,2099,1650,0,51,8.519444444444444,563,1012,3,3,False,False,False,False,False
946725813,-19,2674,2101,1544,0,51,9.020277777777778,573,1130,3,3,False,False,False,False,False
946727618,-19,2668,2099,1624,0,51,9.521666666666667,569,1044,3,3,False,False,False,False,False
946729422,-19,2659,2083,1551,0,50,10.022777777777778,576,1108,2,3,False,False,False,False,False
946731226,-19,2662,2086,1619,0,51,10.523888888888889,576,1043,3,3,False,False,False,False,False
946733030,-19,2663,2082,1539,0,51,11.025,581,1124,3,3,False,False,False,False,False
946734834,-19,2654,2084,1618,0,50,11.526111111111112,570,1036,2,3,False,False,False,False,False
946736638,-19,2654,2079,1525,0,50,12.027222222222223,575,1129,2,3,False,False,False,False,False
946738442,-19,2653,2085,1600,0,34,12.528333333333334,568,1053,2,2,False,False,False,False,False
946740246,-19,2648,2082,1505,0,34,13.029444444444444,566,1143,2,2,False,False,False,False,False
946742050,-19,2650,2074,1593,0,34,13.530555555555555,576,1057,2,2,False,False,False,False,False
946743854,-19,2646,2068,1484,0,34,14.031666666666666,578,1162,2,2,False,False,False,False,False
946745658,-19,2637,2070,1553,0,34,14.532777777777778,567,1084,2,2,False,False,False,False,False
946747462,-19,2643,2056,1446,0,34,15.033888888888889,587,1197,2,2,False,False,False,False,False
946749266,-19,2632,2059,1539,0,34,15.535,573,1093,2,2,False,False,False,False,False
946751070,-19,2630,2053,1421,0,34,16.03611111111111,577,1209,2,2,False,False,False,False,False
946752875,-19,2624,2044,1506,0,34,16.5375,580,1118,2,2,False,False,False,False,False
946754679,-19,2624,2044,1383,0,34,17.038611111111113,580,1241,2,2,False,False,False,False,False
946756483,-19,2611,2035,1487,0,34,17.539722222222224,576,1124,2,2,False,False,False,False,False
946758287,-19,2609,2029,1314,0,34,18.04083333333333,580,1295,2,2,False,False,False,False,False
946760091,-19,2611,2027,1455,0,34,18.541944444444443,584,1156,2,2,False,False,False,False,False
946761895,-19,2605,2018,1292,0,34,19.043055555555554,587,1313,2,2,False,False,False,False,False
946763699,-19,2596,2006,1413,0,34,19.544166666666666,590,1183,2,2,False,False,False,False,False
946765503,-19,2597,1999,1190,0,34,20.045277777777777,598,1407,2,2,False,False,False,False,False
946767307,-19,2588,1987,1343,0,18,20.546388888888888,601,1245,2,1,False,False,False,False,False
946769111,-19,2582,1971,1145,0,18,21.0475,611,1437,2,1,False,False,False,False,False
946770915,-19,2576,1969,1254,0,17,21.54861111111111,607,1322,1,1,False,False,False,False,False
946772719,-19,2564,1959,1170,0,17,22.049722222222222,605,1394,1,1,False,False,False,False,False
946774524,-19,2549,1946,1171,0,17,22.551111111111112,603,1378,1,1,False,False,False,False,False
946776328,-19,2547,1937,1119,0,17,23.052222222222223,610,1428,1,1,False,False,False,False,False
946778132,-19,2536,1910,1080,0,17,23.553333333333335,626,1456,1,1,False,False,False,False,False
946779936,-19,2532,1904,1048,0,17,24.054444444444446,628,1484,1,1,False,False,False,False,False
946781741,-19,2504,1876,1075,0,17,24.555833333333332,628,1429,1,1,False,False,False,False,False
946783546,-19,2502,1855,950,0,17,25.057222222222222,647,1552,1,1,False,False,False,False,False
946785350,-19,2485,1837,980,0,17,25.558333333333334,648,1505,1,1,False,False,False,False,False
946787155,-19,2475,1814,876,0,17,26.059722222222224,661,1599,1,1,False,False,False,False,False
946788960,-19,2452,1775,892,0,17,26.56111111111111,677,1560,1,1,False,False,False,False,False
946790764,-19,2432,1735,874,0,17,27.06222222222222,697,1558,1,1,False,False,False,False,False
946792569,-19,2406,1684,872,0,17,27.56361111111111,722,1534,1,1,False,False,False,False,False
946794373,-19,2382,1632,833,0,17,28.064722222222223,750,1549,1,1,False,False,False,False,False
946796178,-19,2342,1540,832,0,17,28.566111111111113,802,1510,1,1,False,False,False,False,False
946797983,-19,2289,1468,801,0,17,29.0675,821,1488,1,1,False,False,False,False,False
946799788,-19,2223,1381,793,0,17,29.56888888888889,842,1430,1,1,False,False,False,False,False
946801593,-19,2128,1299,779,0,17,30.07027777777778,829,1349,1,1,False,False,False,False,False
946803397,-19,2088,1225,782,2,17,30.57138888888889,863,1306,1,1,False,True,False,False,False
946805202,-19,2066,1162,799,2,17,31.072777777777777,904,1267,1,1,False,True,False,False,False
946807007,-19,1834,758,745,0,17,31.574166666666667,1076,1089,1,1,False,False,False,False,False
946808812,-19,1840,759,755,0,17,32.07555555555555,1081,1085,1,1,False,False,False,False,False
946810616,-19,1942,867,775,2,17,32.57666666666667,1075,1167,1,1,False,True,False,False,False
946812421,-19,1963,865,751,0,17,33.07805555555556,1098,1212,1,1,False,False,False,False,False
946814226,-19,1828,725,759,0,17,33.57944444444445,1103,1069,1,1,False,False,False,False,False
946816031,-19,1923,755,761,2,17,34.08083333333333,1168,1162,1,1,False,True,False,False,False
946817835,-19,1749,793,780,0,17,34.581944444444446,956,969,1,1,False,False,False,False,False
946819640,-19,1809,806,769,2,17,35.083333333333336,1003,1040,1,1,False,True,False,False,False
946821445,-19,1677,1593,1427,6,17,35.584722222222226,84,250,1,1,False,True,True,False,False
946823250,-19,1740,780,788,0,17,36.08611111111111,960,952,1,1,False,False,False,False,False
946825055,-19,1851,807,770,0,17,36.5875,1044,1081,1,1,False,False,False,False,False
946826859,-19,1875,810,772,2,17,37.08861111111111,1065,1103,1,1,False,True,False,False,False
946828664,-19,1883,806,769,0,17,37.59,1077,1114,1,1,False,False,False,False,False
946830469,-19,1899,722,768,2,17,38.091388888888886,1177,1131,1,1,False,True,False,False,False
946832274,-19,1679,1579,1423,4,17,38.592777777777776,100,256,1,1,False,False,True,False,False
946834078,-19,1735,790,855,2,17,39.09388888888889,945,880,1,1,False,True,False,False,False
946835883,-19,1837,787,792,2,17,39.59527777777778,1050,1045,1,1,False,True,False,False,False
946837688,-19,1767,772,861,0,17,40.096666666666664,995,906,1,1,False,False,False,False,False
946839493,-19,1825,796,794,0,17,40.598055555555554,1029,1031,1,1,False,False,False,False,False
946841297,-19,1685,1576,1431,4,17,41.09916666666667,109,254,1,1,False,False,True,False,False
946843102,-19,1807,741,870,2,17,41.60055555555556,1066,937,1,1,False,True,False,False,False
946844907,-19,1770,773,858,2,17,42.10194444444444,997,912,1,1,False,True,False,False,False
946846712,-19,1626,1525,1423,6,17,42.60333333333333,101,203,1,1,False,True,True,False,False
946848516,-19,1788,779,865,0,17,43.10444444444445,1009,923,1,1,False,False,False,False,False
946850321,-19,1694,1595,870,6,17,43.60583333333334,99,824,1,1,False,True,True,False,False
946852126,-19,1660,1559,1432,4,17,44.10722222222222,101,228,1,1,False,False,True,False,False
946853931,-19,1608,1503,1413,6,17,44.60861111111111,105,195,1,1,False,True,True,False,False
946855736,-19,1762,777,880,2,17,45.11,985,882,1,1,False,True,False,False,False
946857540,-19,1804,770,866,0,17,45.611111111111114,1034,938,1,1,False,False,False,False,False
946859345,-19,1693,1582,881,6,17,46.1125,111,812,1,1,False,True,True,False,False
946861150,-19,1803,775,864,2,17,46.61388888888889,1028,939,1,1,False,True,False,False,False
946862955,-19,1650,1535,1425,6,17,47.11527777777778,115,225,1,1,False,True,True,False,False
946864759,-19,1642,1533,1423,4,17,47.61638888888889,109,219,1,1,False,False,True,False,False
946866564,-19,1577,1470,1397,6,17,48.117777777777775,107,180,1,1,False,True,True,False,False
946868369,-19,1762,781,876,2,17,48.619166666666665,981,886,1,1,False,True,False,False,False
946870174,-19,1658,1554,1430,6,17,49.120555555555555,104,228,1,1,False,True,True,False,False
946871978,-19,1607,1489,1404,6,17,49.62166666666667,118,203,1,1,False,True,True,False,False
946873783,-19,1743,758,901,4,17,50.12305555555555,985,842,1,1,False,False,True,False,False
946875588,-19,1616,1494,1411,6,17,50.62444444444444,122,205,1,1,False,True,True,False,False
