timestamp,temp,batt_mV,soundDroop_mV,boltDroop_mV,faults,batteryLevel,Time Elapsed (hours),soundDroopMag_mV,boltDroopMag_mV,meanLevel,nnLevel,fault_brownout,fault_bolt,fault_sound,fault_sound_brownout,fault_bolt_brownout
946693621,-19,3109,2504,2098,2,51,0.0,605,1011,3,3,False,True,False,False,False
946695423,-19,2882,2374,2022,2,51,0.5005555555555555,508,860,3,3,False,True,False,False,False
946697224,-19,2819,2333,1978,2,51,1.0008333333333332,486,841,3,3,False,True,False,False,False
946699026,-19,2802,2313,1951,2,51,1.5013888888888889,489,851,3,3,False,True,False,False,False
946700827,-19,2802,2317,1959,2,51,2.0016666666666665,485,843,3,3,False,True,False,False,False
946702629,-19,2795,2315,1948,2,51,2.502222222222222,480,847,3,3,False,True,False,False,False
946704430,-19,2784,2315,1952,2,51,3.0025,469,832,3,3,False,True,False,False,False
946706232,-19,2793,2312,1948,2,51,3.5030555555555556,481,845,3,3,False,True,False,False,False
946708033,-19,2790,2320,1951,2,51,4.003333333333333,470,839,3,3,False,True,False,False,False
946709835,-19,2791,2315,1937,2,51,4.503888888888889,476,854,3,3,False,True,False,False,False
946711636,-19,2793,2313,1935,2,51,5.004166666666666,480,858,3,3,False,True,False,False,False
946713438,-19,2787,2308,1916,2,51,5.504722222222222,479,871,3,3,False,True,False,False,False
946715239,-19,2783,2313,1884,2,51,6.005,470,899,3,3,False,True,False,False,False
946717041,-19,2785,2300,1887,2,51,6.5055555555555555,485,898,3,3,False,True,False,False,False
946718842,-19,2779,2305,1909,2,51,7.005833333333333,474,870,3,3,False,True,False,False,False
946720644,-19,2781,2302,1899,2,51,7.506388888888889,479,882,3,3,False,True,False,False,False
946722445,-19,2783,2289,1881,2,51,8.006666666666666,494,902,3,3,False,True,False,False,False
946724247,-19,2776,2264,1807,2,51,8.507222222222222,512,969,3,3,False,True,False,False,False
946726048,-19,2777,2238,1750,2,51,9.0075,539,1027,3,3,False,True,False,False,False
946727850,-19,2770,2212,1710,2,51,9.508055555555556,558,1060,3,3,False,True,False,False,False
946729651,-19,2774,2195,1283,0,51,10.008333333333333,579,1491,3,3,False,False,False,False,False
946731454,-19,2771,2136,1315,0,51,10.509166666666667,635,1456,3,3,False,False,False,False,False
946733259,-19,2762,2155,1429,0,51,11.010555555555555,607,1333,3,3,False,False,False,False,False
946735063,-19,2768,2147,1278,0,51,11.511666666666667,621,1490,3,3,False,False,False,False,False
946736867,-19,2769,2141,1111,0,51,12.012777777777778,628,1658,3,3,False,False,False,False,False
946738672,-19,2766,2139,1162,0,51,12.514166666666666,627,1604,3,3,False,False,False,False,False
946740476,-19,2766,2134,1087,0,51,13.015277777777778,632,1679,3,3,False,False,False,False,False
946742281,-19,2759,2126,1202,0,51,13.516666666666667,633,1557,3,3,False,False,False,False,False
946744085,-19,2764,2123,1204,0,51,14.017777777777777,641,1560,3,3,False,False,False,False,False
946745890,-19,2763,2113,1169,0,51,14.519166666666667,650,1594,3,3,False,False,False,False,False
946747694,-19,2759,2108,1252,0,51,15.020277777777778,651,1507,3,3,False,False,False,False,False
946749498,-19,2767,2097,1128,0,51,15.52138888888889,670,1639,3,3,False,False,False,False,False
946751303,-19,2765,2104,1275,0,51,16.022777777777776,661,1490,3,3,False,False,False,False,False
946753107,-19,2765,2089,1061,0,51,16.523888888888887,676,1704,3,3,False,False,False,False,False
946754912,-19,2765,2099,1205,0,51,17.025277777777777,666,1560,3,3,False,False,False,False,False
946756716,-19,2758,2087,1066,0,51,17.52638888888889,671,1692,3,3,False,False,False,False,False
946758520,-19,2764,2093,1074,0,51,18.0275,671,1690,3,3,False,False,False,False,False
946760325,-19,2759,2083,1036,0,51,18.52888888888889,676,1723,3,3,False,False,False,False,False
946762129,-19,2761,2093,1103,0,51,19.03,668,1658,3,3,False,False,False,False,False
946763934,-19,2755,2079,1078,0,51,19.531388888888888,676,1677,3,3,False,False,False,False,False
946765738,-19,2754,2085,996,0,51,20.0325,669,1758,3,3,False,False,False,False,False
946767543,-19,2763,2087,1041,0,51,20.53388888888889,676,1722,3,3,False,False,False,False,False
946769348,-19,2759,2083,1096,0,51,21.03527777777778,676,1663,3,3,False,False,False,False,False
946771152,-19,2751,2070,1016,0,51,21.53638888888889,681,1735,3,3,False,False,False,False,False
946772957,-19,2753,2072,1056,0,51,22.037777777777777,681,1697,3,3,False,False,False,False,False
946774762,-19,2750,2060,1032,0,51,22.539166666666667,690,1718,3,3,False,False,False,False,False
946776566,-19,2754,2069,1043,0,51,23.040277777777778,685,1711,3,3,False,False,False,False,False
946778371,-19,2746,2054,994,0,51,23.541666666666668,692,1752,3,3,False,False,False,False,False
946780176,-19,2746,2055,954,0,51,24.043055555555554,691,1792,3,3,False,False,False,False,False
946781981,-19,2736,2058,972,0,51,24.544444444444444,678,1764,3,3,False,False,False,False,False
946783785,-19,2740,2051,976,0,51,25.045555555555556,689,1764,3,3,False,False,False,False,False
946785590,-19,2745,2038,918,0,51,25.546944444444446,707,1827,3,3,False,False,False,False,False
946787395,-19,2732,2043,977,0,51,26.048333333333332,689,1755,3,3,False,False,False,False,False
946789200,-19,2733,2028,930,0,51,26.549722222222222,705,1803,3,3,False,False,False,False,False
946791005,-19,2733,2031,896,0,51,27.051111111111112,702,1837,3,3,False,False,False,False,False
946792809,-19,2732,2028,869,0,51,27.552222222222223,704,1863,3,3,False,False,False,False,False
946794614,-19,2726,2035,878,0,51,28.05361111111111,691,1848,3,3,False,False,False,False,False
946796419,-19,2724,2041,870,0,51,28.555,683,1854,3,3,False,False,False,False,False
946798224,-19,2718,2054,873,0,51,29.05638888888889,664,1845,3,3,False,False,False,False,False
946800028,-19,2716,2058,857,0,51,29.5575,658,1859,3,3,False,False,False,False,False
946801833,-19,2706,2068,865,0,51,30.058888888888887,638,1841,3,3,False,False,False,False,False
946803638,-19,2706,2071,838,0,51,30.560277777777777,635,1868,3,3,False,False,False,False,False
946805443,-19,2711,2070,872,0,51,31.061666666666667,641,1839,3,3,False,False,False,False,False
946807248,-19,2704,2061,866,0,51,31.563055555555554,643,1838,3,3,False,False,False,False,False
946809052,-19,2694,2053,850,0,51,32.064166666666665,641,1844,3,3,False,False,False,False,False
946810857,-19,2688,2040,863,0,51,32.565555555555555,648,1825,3,3,False,False,False,False,False
946812662,-19,2677,2023,865,0,51,33.066944444444445,654,1812,3,3,False,False,False,False,False
946814467,-19,2679,2015,879,0,51,33.568333333333335,664,1800,3,3,False,False,False,False,False
946816272,-19,2669,1996,871,0,51,34.069722222222225,673,1798,3,3,False,False,False,False,False
946818076,-19,2659,1986,865,0,50,34.57083333333333,673,1794,2,3,False,False,False,False,False
946819881,-19,2651,1969,866,0,34,35.07222222222222,682,1785,2,2,False,False,False,False,False
946821686,-19,2646,1941,848,0,34,35.57361111111111,705,1798,2,2,False,False,False,False,False
946823491,-19,2634,1924,853,0,34,36.075,710,1781,2,2,False,False,False,False,False
946825296,-19,2620,1895,830,0,34,36.576388888888886,725,1790,2,2,False,False,False,False,False
946827100,-19,2613,1873,827,0,34,37.0775,740,1786,2,2,False,False,False,False,False
946828905,-19,2593,1838,804,0,34,37.57888888888889,755,1789,2,2,False,False,False,False,False
946830710,-19,2577,1814,804,0,18,38.08027777777778,763,1773,2,1,False,False,False,False,False
946832515,-19,2568,1764,792,0,17,38.58166666666666,804,1776,1,1,False,False,False,False,False
946834319,-19,2534,1699,784,0,17,39.08277777777778,835,1750,1,1,False,False,False,False,False
946836124,-19,2517,1587,774,0,17,39.58416666666667,930,1743,1,1,False,False,False,False,False
946837929,-19,2484,1489,765,2,17,40.08555555555556,995,1719,1,1,False,True,False,False,False
946839734,-19,2402,1000,754,0,17,40.58694444444444,1402,1648,1,1,False,False,False,False,False
946841539,-19,2298,792,759,6,17,41.08833333333333,1506,1539,1,1,False,True,True,False,False
946843343,-19,2260,805,776,6,17,41.589444444444446,1455,1484,1,1,False,True,True,False,False
946845148,-19,2199,796,926,6,17,42.090833333333336,1403,1273,1,1,False,True,True,False,False
946846953,-19,2198,792,915,6,17,42.59222222222222,1406,1283,1,1,False,True,True,False,False
946848758,-19,2183,768,922,6,17,43.09361111111111,1415,1261,1,1,False,True,True,False,False
946850562,-19,2174,837,961,6,17,43.594722222222224,1337,1213,1,1,False,True,True,False,False
946852367,-19,2147,790,948,6,17,44.096111111111114,1357,1199,1,1,False,True,True,False,False
946854172,-19,2125,799,947,6,17,44.5975,1326,1178,1,1,False,True,True,False,False
946855977,-19,2112,761,977,6,17,45.09888888888889,1351,1135,1,1,False,True,True,False,False
946857782,-19,2131,808,988,6,17,45.60027777777778,1323,1143,1,1,False,True,True,False,False
946859586,-19,2103,790,978,6,17,46.10138888888889,1313,1125,1,1,False,True,True,False,False
946861391,-19,2093,1279,980,6,17,46.602777777777774,814,1113,1,1,False,True,True,False,False
946863196,-19,2072,1235,974,6,17,47.104166666666664,837,1098,1,1,False,True,True,False,False
946865001,-19,2099,1851,988,6,17,47.605555555555554,248,1111,1,1,False,True,True,False,False
946866806,-19,2011,755,1007,6,17,48.106944444444444,1256,1004,1,1,False,True,True,False,False
946868610,-19,2054,782,965,6,17,48.60805555555555,1272,1089,1,1,False,True,True,False,False
946870415,-19,2040,763,1022,6,17,49.10944444444444,1277,1018,1,1,False,True,True,False,False
